style                      = стиль
stylist                    = стилист                                  # 14+

formal                     = формальный %% стиль официальных приемов  # +1sec # RANDOM- # pix- # 16+ /// (очень формальный)
informal                   = деловой %% нейтрально-деловой стиль      # +1sec # RANDOM- # pix- # 16+ /// (все же весьма формальный)
casual                     = кэжуал %% повседневный стиль             # +1sec # RANDOM- # pix- # 16+ /// (неформальный, повседневный)
sporty                     = спортивный                               # RANDOM- # 16+

ensemble                   = ансамбль                                 # 16+ /// # polysemic
dress code                 = дресс-код                                # 14+
uniform                    = униформа, форма %% в том числе военная
school uniform             = школьная форма

fashion                    = мода, манера, ~ реже: покрой, фасон      # 16+
fashionable                = модный, ~ иногда: фешенебельный          # 16+
fashion show               = показ мод
masquerade                 = маскарад                                 /// арабский: место где насмехаются -> итал. фр. максарад -> маска
model                      = модель                                   # 14+ /// (в знач. профессии)

costume                    = костюм %% театральный, национальный, ~ но не классический или деловой
blazer                     = блейзер                                  # RARE+ # 18+
jeans                      = джинсы
pair of jeans              = пара джинсов
shorts                     = шорты
Bermudas, ~ Bermuda shorts = бермуды                                  # RARE- # 10+
leggings                   = лосины, легинсы                          # 16+
pullover                   = пуловер                                  # 14+
sweater {Am.}              = свитер
cardigan                   = кардиган                                 # RARE+ # 16+

bikini                     = бикини                                   # 16+
sarong                     = саронг                                   # RARE- # 18+
pāreu|pareo                = парео                                    # RARE- # 18+
tunic                      = туника                                   # 18+

top                        = топ/топик %% также любая другая одежда ~ для верхней части тела # 18+
topless                    = топлес                                   # 18+

