art                       = искусство
---
comic                     = комик, комический, ~ комикс
comics                    = комиксы, ~ комики
comedian                  = комедийный актёр, ~ автор комедий   # 10+
tragedian                 = трагик                              # 10+
tragicomedy               = трагикомедия                        # 16+

eclectic                  = эклектичный                         # 18+ /// (разнородный) (разнородный, эклектический, фрагментарный)
expressive                = выразительный, экспрессивный        # 16+
harmonious                = гармоничный                         # 10+
disharmony                = дисгармония, разногласие            # 10+
grotesque                 = гротеск, гротескный                 # 16+
illusory                  = иллюзорный

debutante                 = дебютантка                          # 14+ /// можно дать только ж.р., м. сомнителен здесь
festival                  = фестиваль
biennale                  = биеннале %% ''досл. с'' итал. «каждый второй год» # 18+
féerie                    = феерия                              # 18+

interpretation            = интерпретация, трактовка            # 10+
imitation                 = имитация, подражание                # 10+
epigone                   = эпигон %% неоригинальный последователь # RARE+ # 18+
plagiarism                = плагиат                             # 10+
compilation               = компиляция                          # 18+

masterclass||master class = мастер-класс
diorama                   = диорама                             # ART+ # RARE+ # 18+
restoration               = реставрация, восстановление, ~ реконструкция # 10+
model @ maquette          = модель, макет

===

provenance                = провенанс %% история владения памятником искусства # ART+ # 16+
authentic                 = аутентичный, подлинный              # ART+ # 16+
attribution               = приписывание, отнесение, ~ атрибуция # ART+ # 18+



