
portraitist             = портретист

model @ fineart         = модель
pose                    = поза, позировать

composition @ fineart   = композиция                                            /// , ~ сочинение, произведение
perspective @ fineart   = перспектива                                           # 10+

ochre\\ocher            = охра                                                  # 16+
indigo                  = индиго                                                # 14+
tempera                 = темпера                                               # ART+ # 16+

aquarelle               = акварель %% ''в особенности:'' картина, ~ написанная акварелью # 10+ /// French
watercolour\\watercolor = акварель, ~ акварельные краски                        # 10+

technique @ art         = техника                                               # 14+
sketch                  = набросок, эскиз, скетч, ~ делать набросок             # 16+
fresco/mural            = фреска                                                # 14+
sfumato                 = сфумато %% смягчение очертаний ~ фигур и предметов на картине # ART+ # 18+

diptych                 = ди́птих                                                # 18+ /// (ударение ''дипти́х'' считается ненормативным)
triptych                = три́птих                                               # 18+ /// (ударение ''трипти́х'' считается ненормативным)

===

Leonardo da Vinci       = Леонардо да Винчи                                     # ART+ # 10+
Michelangelo Buonarroti = Микеланджело Буонарроти                               # ART+

Raphael/Raphaello       = Рафаэль                                               # ART+
Pre-Raphaelites         = прерафаэлиты                                          # ART+ # 18+

===

impressionists          = импрессионисты                                        # ART+ # 14+
postimpressionism       = постимпрессионизм                                     # ART+ # 18+
suprematism             = супрематизм                                           # ART+ # 18+
surrealism              = сюрреализм                                            # ART- # 16+
photorealism            = фотореализм                                           # ART- # TERM- # 14+

===
graphics @ art          = графика                                               # 10+
===

illustration            = иллюстрация
caricature              = карикатура                                            # 10+

graffiti                = граффи́ти                                              # 10+
pop art                 = поп арт                                               # 14+
poster                  = постер, плакат, афиша
lithography             = литография                                            # TERM+ # 18+
facsimile               = факси́миле %% точное воспроизведение ~ рукописи, гравюры, монограммы # RARE+ # TERM+ # 16+




