port                  = порт, гавань                                         # 10+
pier                  = пирс, дамба, мол                                     # 10+

container             = контейнер                                            # RANDOM- /// , ёмкость, сосуд
container terminal    = контейнерный терминал                                # TERM- # 10+
tanker                = танкер                                               # 10+
barge                 = баржа, барка                                         # 10+

yacht                 = яхта
yachtsman             = яхтсмен
yacht club            = яхт-клуб                                             # TECH- # TERM-
marina                = марина %% стоянка яхт                                # TECH- # TERM- # 16+

yacht {2}             = яхта
schooner              = шхуна                                                # 14+

felucca               = фелука                                               # RARE+ # TECH+ # TERM+ # RANDOM- # 18+
junk                  = джонка                                               # RARE+ # TECH+ # TERM+ # RANDOM- # 18+
pirogue               = пирога                                               # 18+
skiff                 = скиф %% тип лодки                                    # RARE+ # TECH+ # TERM+ # RANDOM- # 18+

gondola %% Venitian   = гондола                                              # 10+
gondolier             = гондольер                                            # 10+
barcarole|barcarolle  = баркарола %% песня венецианских гондольеров          # RARE- # 16+
gondola               = гондола %% кабина воздушного шара, дирижабля, канатной дороги

canal/channel         = канал %% channel – естественный канал, ~ canal – искусственный
the Suez Canal        = Суэцкий канал                                        # TERM- # 10+
the Panama Canal      = Панамский канал                                      # TERM- # 10+
the [English] Channel = Ла-Манш ~ (Английский канал)                         # 10+

pilotage              = проводка судов, ~ пилотаж                            # TECH+ # TERM+ # 10+
cabotage              = каботаж                                              # TECH+ # TERM+ # 18+ /// («от мыса к мысу») (плавание судов между портами одного государства)

ballast               = балласт, грузить балластом, ~ устойчивость, придавать устойчивость # 10+
buoy                  = буй                                                  # 10+
drift                 = дрейф, дрейфовать                                    # TECH- # TERM- # 10+
keel                  = киль                                                 # 10+
mast                  = мачта
propeller             = гребной винт                                         # 10+

tonnage               = тоннаж                                               # TECH- # TERM- # 18+
waterline             = ватерлиния                                           # TECH- # TERM- # 10+

sonar                 = сонар, гидролокатор                                  # TECH- # TERM- # 14+
hydroacoustics        = гидроаккустика                                       # TECH- # TERM- # 14+
echolocation          = эхолокация                                           # TECH- # TERM- # 14+ /// у летучих мышей тоже
compass               = компас  %% ''в жаргоне моряков:'' компа́с

