{FF}

family                  = семья %% не фамилия
''family business''     = ''семейный бизнес''
''family doctor''       = ''семейный врач''                                 # +2sec

familiar                = знакомый, привычный, близкий, ~ реже: фамильярный # 16+

initial                 = исходный, начальный, ~~ заглавный (о букве), ~ не только инициал # 10+

jest                    = остро́та, шутка, насмешка, ~ шутить, насмехаться %% ''не'' жест
gesture                 = жест                                              # +2sec

mimic                   = подражать, передразнивать, ~ не только мимика     # +2sec

complexion              = цвет лица, ~ вид, характер %% ''не'' комплекция   # 16+
''healthy complexion''  = ''здоровый цвет лица''

subtle                  = тонкий, искусный, неуловимый %% ''не'' субтильный # +2sec # 16+ /// хитрый и др. /// перен.

marginal                = крайний, предельный, боковой, ~ не только маргинальный # 18+
''marginal note''       = ''заметка на полях''                              # 18+
''marginal control''    = ''минимальная управляемость''                     # +2sec # 18+

humour\\humor           = настроение, нрав, ~ не только юмор                # 10+ /// потакать /// не только юмор, чувство юмора
''good-humoured''\\''good-humored'' = ''добродушный, благодушный''                      # 10+
''ill-humoured''\\''ill-humored'' = ''в дурном настроении''                           # +2sec # 10+

spleen                  = селезёнка ~~ формальное: злоба, раздражение %% ''значение'' сплин, хандра ''устарело'' # 16+

amoral                  = нейтральный в отношении морали, ~ не только: аморальный, безнравственный # 14+
immoral                 = аморальный, безнравственный                       # +2sec # 14+

scoundrel               = негодяй, подлец, мерзавец %% ''не'' скандалист
debauch                 = распущенность, ~ совращать, разлагать, ~ не только дебош, пирушка # 18+
debaucher               = распутник, соблазнитель %% ''не'' дебошир         # +2sec # 18+ /// # DELAY

extravagance            = расточительство, излишество, ~ сумасбродство, ~ реже: экстравагантность # 14+

intimate                = близкий, сокровенный, ~ не только интимный
intimate friend         = близкий друг                                      # +2sec

courage                 = мужество, отвага %% ''не'' кураж                  # 10+
honour\\honor           = честь, почёт, слава %% ''не'' гонор               # 16+ /// очень много значений /// , ~ удостаивать чести, чтить
<small>''Medal of Honor''</small>

loser                   = проигравший, ~ не только лузер|неудачник          # 10+

coward                  = трус %% ''не'' коварный                           # +1sec
<small>''But I am not a brave man; ~ never said I was a brave man; ~ I am a coward.''</small> = %% ''Moby Dick'' by Herman Melville               # +2sec

ignorance               = неведение, невежество %% ''не'' игнорирование     # +2sec # 10+
''Ignorance is bliss.'' = ''Счастье в неведении.''
<small>''Only ignorance! only ignorance! how can you talk about only ignorance? Don't you know that it is the worst thing in the world, next to wickedness?''</small>

