Latin             = латинский, латынь                    # pix- # 8+
===
: Est deus in nobis (there is a god within us) – Ovid
===
Londinium         = Лондиниум %% город Римской Британии ~ на месте современного ~ Лондона # 14+
===

aquarium          = аквариум
aqueduct          = акведук                              # 14+
arena             = арена                                /// , спортивный комплекс, стадион
gladiator         = гладиатор                            # 12+
equilibristics    = эквилибристика                       # 10+

fragment          = фрагмент, отрывок, ~ обломок, осколок # 10+ /// , ~ раскалывать, разбиваться
interval          = интервал, перерыв, ~ промежуток ~ (времени)
result            = результат, итог                      /// , ~~ происходить в результате, иметь результатом

company @ group   = компания, общество                   /// , труппа, в военном деле: воинская единица
procession        = процессия, шествие                   # 14+ /// литания, исхождение Святого Духа
tradition         = традиция, обычай                     # 10+ /// , в юриспруденции: вручение, передача
situation         = ситуация
impulse           = импульс, порыв, ~ толчок             # 10+
reaction          = реакция, отклик                      /// , ухудшение самочувствия, протест
incident          = случай, происшествие, ~ инцидент     /// , столкновение, ~~свойственный, характерный
absurd            = абсурд, абсурдный, ~ нелепый         # 10+
fatal             = роковой, смертельный, ~ губительный, фатальный # 10+
alternative       = альтернатива, ~ альтернативный       # 10+

conflict @ noun   = конфликт, столкновение, ~ противоречие /// `conflict
conflict @ verb   = противоречить                        /// con`flict

visit             = визит, ~ посещение, посещать
announce          = объявлять                            # 10+
inform            = сообщать, информировать
secret            = секрет, секретный ~ тайна, тайный
text              = текст                                /// , текстовое сообщение, ~~отправлять СМС
document          = документ                             /// , бумага, свидетельство

real @ true       = реальный, настоящий, ~ подлинный     # 10+ /// , реально существующий
surrogate         = суррогат, суррогатный                # 16+
norm              = норма
illusion          = иллюзия
lacuna            = пробел, пропуск, ~ лаку́на            # RARE+ # 18+ /// ~ в биологии: полость
ultramarine       = ультрамарин                          # 14+ /// , ультрамариновый цвет
oval              = овал, овальный
candelabrum       = канделябр                            # 14+
collection        = коллекция, собирание                 /// , сбор, ~~ сбор денег, пожертвования
villa             = вилла, особняк                       # 10+ /// , ~~усадьба (в Древнем Риме)

===

individual @ adj. = отдельный, личный, ~ индивидуальный  # 10+
individual @ noun = человек, лицо, ~ индивидуум          # 10+

alter ego         = альтер эго                           # 16+
discomfort        = дискомфорт, неудобство               # 10+
depression        = депрессия, уныние                    # 10+
deviation         = отклонение, девиация                 # TERM+ # 16+







