===
Mesopotamia         = Месопотамия/Междуречье   # 12+
===

Tigris              = Тигр                     # 12+
Euphrates           = Ефрат                    # 12+

Sumerians           = шумеры                   # 12+
Babylon             = Вавилон                  # 12+
ziggurat            = зиккурат                 # HISTORY- # RARE- # 16+

===

Assyria             = Ассирия                  # HISTORY+ # 16+
Phoenicia           = Финикия                  # HISTORY+ # 16+

===
Ancient Egypt       = Древний Египет
===

Memphis             = Мемфис                   # HISTORY+ # 16+
Luxor               = Луксор                   # HISTORY+ # 16+
Thebes @ Egypt      = Фивы ~ (стовратные)      # HISTORY+ # 16+

obelisk             = обелиск
papyrus             = папирус                  /// (писчий материал) (водное растение)
pyramids of Giza    = пирамиды Гизы            # DEL
sphinx              = сфинкс                   /// Great Sphinx of Giza
pharaoh             = фараон

===
Minoan civilization = Минойская цивилизация    # 16+
===

Crete               = Крит                     # 12+
Knossos             = Кносс                    # HISTORY+ # 16+

labyrinth           = лабиринт                 # 12+
tauromachy          = тавромахия               # HISTORY+ # RARE+ # 18+

===
Santorini @ volcano = Санторини                /// ~ (Тира, Фира)
= Закат минойской цивилизации ~ начался с извержения вулкана ~ Санторин. # 16+
= Глубина кальдеры, ~ мгновенно заполненной морем, ~ составляет 300--400 метров. # 16+
===

Antiquity ~ (classical antiquity) = античность               # 12+



