philosophy,~philosopher       = философия, философ
philosophe                    = философ-просветитель (Вольтер, Дидро, Руссо и др.) # TERM+

metaphysics                   = метафизика
dialectic/dialectics          = диалектика
materialism                   = материализм
idealism                      = идеализм
objective                     = объективный                                # 16+
subjective                    = субъективный                               # 16+

agnosticism                   = агностицизм («Ничего не существует; но даже если нечто существует, то оно непознаваемо; но даже если и познаваемо, то необъяснимо для другого». -- Горгий (древнегреческий софист)) # TERM+
anthropocentrism              = антропоцентризм                            # TERM+
scholasticism                 = схоластика                                 # TERM+

maxim                         = максима, афоризм, принцип
abstraction                   = абстракция
simulacrum                    = симулякр                                   # RARE+ # TERM+ /// («копия», не имеющая оригинала в реальности)
empirical                     = эмпирический
immanent                      = имманентный, присущий, неотъемлемый        # TERM+
quintessence                  = квинтэссенция, ~ воплощение (чего-либо) ~ в философии: эфир # TERM-
rigorism                      = ригоризм                                   # RARE+ # TERM+
nihilism                      = нигилизм

Epicurus,~epicurean           = Эпикур, эпикурейский                       # TERM-
hedonism,~hedonist            = гедонизм, гедонист

Socrates                      = Сократ
Plato                         = Платон
Aristotle                     = Аристотель
mimesis                       = мимесис/мимезис (подражание искусства действительности) # RARE+ # TERM+
tabula rasa                   = табула раса                                # RARE+ # TERM+

Cynic                         = киник                                      /// (философ, представитель школы киников, Диоген в частности)
cynic                         = циник

stoic                         = стоик, стоический
Seneca                        = Сенека

René Descartes                = Рене Декарт (лат. Renatus Cartesius)       # RARE+ # TERM+ /// 1596 - 1650
Cartesian                     = картезианский, картезианец, ~ декартовский # RARE+ # TERM+ /// (“Cogito, ergo sum” (лат.) -- «мыслю, следовательно, существую»)

Immanuel Kant                 = Иммануил Кант                              # RARE+ # TERM+ /// 1724 - 1804
categorical imperative        = категорический императив                   # RARE+ # TERM+

Hegelian triad                = гегелевская триада                         # RARE+ # TERM+ /// 1770 - 1831
thesis,~antithesis,~synthesis = тезис, антитезис, синтез                   # RARE+ # TERM+

existentialism                = экзистенциализм                            # RARE+ # TERM+ /// Kierkegaard Кьеркегор /// 1813 - 1855


