basic ~ vocabulary

dozen          = дюжина /// French
hundred        = сто, сотня
thousand       = тысяча
one and a half = полтора

weight         = вес, взвешивать
light @ weight = лёгкий
heavy @ weight = тяжёлый
---
size           = размер
length         = длина
long           = длинный
short          = короткий
: short pasta
: long pasta
---
inch @ unit = дюйм
: Why can’t your nose be 12 inches long? Because then it would be a foot.
---
large          = большой, крупный, ~ многочисленный
huge           = огромный, громадный, ~ гигантский

height         = высота
high           = высокий
low            = низкий

thickness      = толщина
thick          = толстый
thin           = тонкий

depth          = глубина
deep           = глубокий
shallow        = мелкий
---
wide           = широкий
narrow         = узкий
: wide interested eyes
: Open wide and say “ahh”.

hour           = час
hourglass      = песочные часы

week           = неделя
month          = месяц
year           = год

===
volume @ space = объём
volume @ sound = громкость
volume @ book  = том




