Proto-Indo-European = праиндоевропейский ~ (язык) %% гипотетический предок русского, английского и многих других языков # 8+

===
mother              = мать %% ''устарeвшее:'' матерь, ~ ''сохранилась форма:'' матери
daughter            = дочь %% ''устарeвшее:'' дочерь, ~ ''сохранилась форма:'' дочери
son                 = сын

===
brother             = брат
sister              = сестра
: brother and sister // pix

===

nose                = нос
brow                = бровь, ~ также: лоб
beard               = борода

my                  = мой
me                  = мне, меня, мной

no                  = нет, не
not                 = не, ни, нет

two                 = два %% древнеанглийское twa звучало ~ совсем похоже
three               = три
seven               = семь

be                  = быть                                                      # 10+
is                  = есть %% ''устаревшая форма глагола'' быть ''3 л. ед.ч.''  # 10+
will                = воля, велеть                                              # 10+ /// , также: желание, желать

sit                 = сидеть
stand               = стоять, ~ стенд, стоянка                                  /// (такси и проч.)

step                = шаг, ступать
steps               = ступени

lie @ pose          = лежать                                                    /// *legʰ
lie @ false         = ложь, лгать %% Слова ''лежать'' и ''ложь'' похожи, ~ но они восходят к разным ~ праиндоевропейским корням. /// *lewgʰ

new                 = новый
young               = юный, молодой                                             # 8+
naked               = нагой, ~ обнаженный, голый                                # 14+

cold                = холод, холодный ~~ простуда
small               = маленький

mortal              = смертный                                                  # 10+
widow               = вдова                                                     # 12+

door                = дверь
wall                = стена %% тот же корень, что и в слове ''вал''             # 10+
guest               = гость %% У праиндоевропейцев было также значение ''чужестранец''.

plait\\braid        = плести, заплетать ~ (косу)
mash                = месиво, месить, ~ пюре
grab                = хватать, схватить %% тот же корень, что и в словах ~ ''грабить, грабли'' # 10+
same                = то же ''самое'', ~ такой же


