waves                      = в физике: волны                             # 18+

standing/stationary wave   = стоячая волна
amplitude                  = амплитуда
phase,~antiphase           = фаза, антифаза
hertz                      = герц                                        # 18+
resonance                  = резонанс                                    # 18+
harmonic oscillator        = гармонический осциллятор                    # MATH+ # TERM+ # 18+
coherent                   = когерентный, ~ связный (о тексте), ~ членораздельный # MATH+ # 18+

interference               = интерференция ~ (наложение волн) ~ вмешательство, ~ помехи (радио и проч.) () # MATH- # 18+
diffraction                = дифракция                                   # MATH- # 18+
Doppler effect             = эффект Доплера                              # MATH- # 18+

spectrum,~visible spectrum = спектр, ~ видимая часть спектра             # MATH- # TERM- # 18+
ultraviolet                = ультрафиолетовый
infrared                   = инфракрасный
radio waves                = радиоволны                                  # 18+
spectral line              = спектральная линия                          # MATH+ # TERM+ # 18+
spontaneous emission       = спонтанное излучение/испускание             # MATH+ # TERM+

luminescence               = люминесценция (нетепловое свечение вещества) # 18+
fluorescence               = флюоресценция/флуоресценция (разновидность люминесценции) # 18+
fluorescent lamp           = люминесцентная лампа                        # 18+

acoustics                  = акустика
decibel                    = децибел
reverberation              = ревеберация ~ отзвук, эхо                   # MATH+ # 18+
sonic boom                 = звуковой удар

optics                     = оптика
lens                       = линза, лупа, ~ также: объектив, ~ хрусталик глаза
dioptre                    = диоптрия                                    # 18+

stereoscopic               = стереоскопический                           # 18+
parallax                   = параллакс                                   # MATH+ # 18+

moire                      = муар (муаровый узор)                        # MATH+ # TERM+ # 18+
chromatic aberration       = хроматическая аберрация                     # MATH+ # TERM+ # 18+
refraction                 = преломление/рефракция                       # MATH+ # TERM+ # 18+
dispersion                 = дисперсия (Ньютон ввел термин дисперсия в физику, описывая разложение белого света в спектр при прохождении через призму.) # MATH+ # TERM+ # DEL # 18+
polarization,~polarizer    = поляризация, поляризатор                    # MATH+ # TERM+ # 18+
corpuscular                = корпускулярный                              # MATH+ # TERM+ # 18+

laser                      = лазер, лазерный
holography,~hologram       = голография, голограмма


