mentality                  = склад ума, менталитет             # 16+
stereotype                 = стереотип                         # 10+

ironical/ironic            = ироничный                         # 10+
sarcastic                  = саркастичный                      # 10+
cynical                    = циничный                          # 16+
sardonic                   = сардонический                     # 18+

analytical                 = аналитический                     # 10+
instinctive                = инстинктивный                     # 10+
intuitive                  = интуитивный                       # 10+

idealist                   = идеалист                          # 10+
realist                    = реалист                           # 10+
altruist                   = альтруист                         # 16+
formalist                  = формалист                         # 16+
pedant                     = педант                            # 16+
eccentric                  = эксцентричный, чудак              # 16+
sceptic\\skeptic           = скептик                           # 10+
cynic                      = циник
fanatic                    = фанатик, фанатичный               # 10+

romantic                   = романтичный
infantile                  = инфантильный                      # 18+
capricious                 = капризный
pretentious                = претенциозный, ~ показной         # 16+
extravagant @ extra        = сумасбродный, нелепый, ~ экстравагантный # 16+

rational                   = рациональный, ~ разумный
practical                  = практичный, ~ практический        # 10+
impractical                = непрактичный                      # 10+
mercantile                 = меркантильный                     # formal # 16+
diplomatic                 = дипломатичный                     # 10+

organized %% Br. also: organised = организованный
pragmatic                  = прагматичный                      # 18+
serious                    = серьёзный
scrupulous                 = щепетильный, ~ скрупулёзный       # 16+

misanthropist//misanthrope = мизантроп %% человеконенавистник  # 18+
philanthropist             = филантроп                         # 18+ /// philanthrope устар.
individualist              = индивидуалист                     # 10+

===

: Ah! what a cynic you are!






