family tree

parents              = родители
siblings             = брат и сестра, ~ братья и сестры
twins                = близнецы

===

grandmother//grandma = бабушка
grandfather//grandpa//granddad = дедушка

granddaughter        = внучка
grandson             = внук

===

great-grandmother    = прабабушка
great-grandmother    = прадедущка

===

: Grandfather paradox -- so let's suppose

===

aunt                 = тетя
uncle                = дядя
nephew               = племянник
niece                = племянница

===

: Ah, you must be ~ our crazy aunt Lidia!

===

stepmother           = мачеха
stepfather           = отчим
stepdaughter         = падчерица
stepson              = пасынок
half brother         = сводный брат
half sister          = сводная сестра

mother-in-law        = свекровь
father-in-law        = тесть
daughter-in-law      = невестка
son-in-law           = зять
brother-in-law       = шурин, деверь
sister-in-law        = золовка, свояченица

===



