basic ~ vocabulary
===
life     = жизнь # 18+
death    = смерть # 18+
live     = жить, живой, ~ реальный, действующий
die      = умереть, умирать, ~ затухать
: Death and Life
===

body     = тело
head     = голова
face     = лицо
shoulder = плечо
arm      = рука
hand     = рука ~ (кисть)
leg      = нога
knee     = колено

finger   = палец (на руке)
thumb    = большой палец
toe      = палец (на ноге)

eye      = глаз
ear      = ухо
mouth    = рот
lips     = губы
cheek    = щека

===

men
woman

baby boy
baby girl

===
---
happy    = счастливый, довольный
sad      = грустный
: You look sad.

shy      = застенчивый, стеснительный, ~ робкий
odd      = странный
crazy    = сумашедший, безумный, ~ чокнутый







