{FF}

communicable             = заразный, передающийся %% не только коммуникабельный/общительный # 12+

cavalier                 = высокомерный, надменный, ~ развязный, бесцеремонный ~~ рыцарь, кавалерист ~~ иногда: кавалер # 12+
<small>''The Laughing Cavalier''</small> # +2sec # 12+

delicate                 = нежный, хрупкий, утончённый, ~ деликатный %% ''но не'' в знач. тактичный

pathetic                 = жалкий, жалостный, ~ трогательный %% ''не'' патетичный # 16+

glum/gloomy              = угрюмый, мрачный %% ''не'' глумливый                 # 16+

genial                   = доброжелательный, ~ добрый, веселый, ~ реже: гениальный /// # DELAY /// гениальный это устаревшее значение ??

exultation               = ликование, торжество %% ''не'' экзальтация           # 16+ /// # DELAY
exaltation               = экзальтация                                          # +2sec # 16+ /// # DELAY

prostration              = распростертое положение, ~ изнеможение, ~ не только прострация # 16+

agony                    = му́ка, мучение, страдание, ~ иногда: агония           # 16+
<small>''Agony of Cain''</small> # +2sec # 16+

treat                    = относиться, обходиться %% ''не'' третировать         # 16+
<small>''Treat suspect as armed and dangerous.''</small>

adept                    = знаток, искусный %% ''не'' адепт                     # 16+

adventure                = приключение, ~ иногда: авантюра

pretend                  = притворяться, ~ иногда: претендовать                 # 16+
pretender                = притворщик, ~ также: претендент %% на трон, титул и т.п., ~ не имеющий законных прав # +2sec # 16+
<small>''Nurse! Do let's pretend ~ that I'm a hungry hyaena, ~ and you're a bone.''</small> = %% Lewis Carroll, ''Through the Looking-Glass'' ~ ARDIS

complement               = дополнение, дополнять, ~ комплект %% ''не'' комплимент # pix- /// # polysemic /// лингв. дополнение, воен. личный состав
compliment               = комплимент, ~ похвала, поздравление                  # +2sec # pix- /// , ~ делать комплимент

intelligent              = умный, способный, разумный %% ''не'' интеллигент     # 14+ /// ~~ обладающий искусственным интеллектом
<small>''Computers are not intelligent. ~ They only think they are.''</small> = %% ''British toilet graffiti'' ~ HOTMAG
intelligence             = ум, сообразительность
intelligence {espionage} = разведывательная служба, ~ разведывательные данные   # POLIT- # WAR- # 14+ /// # polysemic /// сведения, информация
''Central Intelligence Agency'' = ''Центральное разведывательное управление''          # POLIT- # WAR- # +2sec # 14+ /// ~ (CIA) /// ЦРУ %% /// США

senior                   = пожилой, старший ~ (по возрасту/должности) ~~ старшеклассник (бр.) ~~ старшекурсник (ам.) %% ''не'' сеньор # 14+
señor|senhor             = сеньор %% уважительное обращение ~ в Испании и Португалии соответственно # 14+
seignior/seigneur        = сеньор, феодал                                       # +2sec # 14+ /// # polysemic /// %% also: seigneur

