bon appétit!              = приятного аппетита! %% (фр.)

===
appetite                  = аппетит, охота ~ (до чего-либо)
apéritif|aperitif         = аперитив              # 18+

soup                      = суп
cream soup                = суп-пюре
bouillon                  = бульон %% или суп на бульоне # duple
consommé|consomme         = консоме %% осветлённый бульон # RARE+ # 18+
escalope {Br.}            = эскалоп               # 10+
fillet\\filet @ food      = филе                  # 10+
fricassee                 = фрикасе               # RARE+ # 18+

baguette                  = багет
croissant                 = круассан
galette                   = галета                # 10+

mayonnaise                = майонез
margarine                 = маргарин              # 10+
marinade                  = маринад               # 10+
omelette\\omelet          = омлет
sauce                     = соус, изюминка %% Предок французского sauce («соус») – ~ латинское слово sal («соль»). /// ; то, что придаёт пикантность
lemonade                  = лимонад
champignon                = шампиньон             # 10+
flambé                    = фламбирование/фламбе  # RARE- # 18+
fondue                    = фондю                 # MILK # RARE- # 16+

=======

dessert                   = десерт
caramel                   = карамель
crème brûlée              = крем-брюле            # 10+
blancmange                = бланманже             # RARE- # 18+
éclair|eclair             = эклер
mousse                    = мусс                  # 10+
profiteroles {Br.}        = профитроли            # RARE- # 16+
souffle|soufflé           = суфле                 # 10+
dragée                    = драже

cafe|café                 = кафе
restaurant                = ресторан
menu                      = меню
maître d'hôtel\\maître d' = метрдотель            # 18+
chef                      = шеф-повар
gourmand                  = гурман, ~ также: обжора # duple
banquet                   = банкет                # 16+ /// , давать банкет
picnic                    = пикник                /// , устраивать пикник
champagne                 = шампанское            # 18+
cognac                    = коньяк                # 18+












