&nbsp;

administration          = администрация, управление
territory               = территория, местность
dictator                = диктатор                                              # 10+
prefecture              = префектура, ~ должность префекта                      # 10+
senator                 = сенатор                                               # 10+ /// , Senator
status                  = статус, ~ общественное положение                      # 10+
regalia %% uncountable  = регалии                                               # 18+
privilege               = привилегия                                            # 10+ /// , преимущество, честь #polysemic // абсолютный иммунитет (члена парламента) от исков с обвинением в диффамации
august @ adjective      = августейший, величественный                           # 16+

nation                  = нация, народ, страна
public                  = публика, общественность, ~ публичный                  # 12+ /// , общественный, государственный, гласный
republic                = республика                                            # 12+
plebs                   = плебеи, ~ в Древнем Риме: плебс                       # 16+
plebiscite              = плебисцит                                             # POLIT- # TERM- # 18+
referendum %% plural referendums/referenda = референдум                                            # POLIT- # TERM- # 16+
forum                   = форум                                                 # 10+ /// , суд
orator                  = оратор                                                # 10+
opponent                = конкурент, оппонент, ~ противоположный, противоречащий, ~ враждебный # 10+
censor                  = цензор, блюститель нравов                             # 12+ /// , подвергать цензуре

corruption              = коррупция, распад, разложение                         # 12+
emigration              = эмиграция                                             # 12+
revolution              = революция, переворот, ~ оборот, вращение              # 10+

progress @ noun %% noun = прогресс, развитие                                    # 10+ /// `progress /// , продвижение, успехи, ход
progress @ verb %% verb = прогрессировать, развиваться                          # 10+ /// pro`gress

export @ noun           = экспорт, экспортный                                   # 10+ /// `export /// , экспортируемый товар
export @ verb %% verb   = экспортировать                                        # 10+ /// ex`port

import @ noun %% noun   = импорт                                                # 10+ /// `import
import @ verb %% verb   = ввозить, импортировать                                # 10+ /// im`port
import @ mean           = смысл, суть, сущность, значение                       # 10+ /// `import
important               = важный, значительный                                  # 10+

consultant              = консультант                                           # 10+
director                = директор, руководитель, ~ режиссёр, реже: дирижёр
magnate                 = магнат                                                # 10+
patent                  = патент, патентовать, ~ патентованный                  # 10+
bonus                   = бонус, премия
auction                 = аукцион                                               # 10+

pension @ paid          = пенсия, пособие
pension @ hotel         = пансион                                               # 14+ /// /pɑːnsiˈoʊn/

