''Parentheses''

actually\\in fact      = на самом деле
as a matter of fact    = на самом деле
the fact is this       = дело в том, что
''The fact is ~ that I find this place rather tedious.'' = %% Oscar Wilde, ''The Happy Prince. Tales.'' ~ ARDIS
the thing is this      = дело в том, что
''So, here's the thing...''

however                = однако
besides                = кроме того
moreover               = более того
also                   = также
by the way             = кстати
''By the way, ~ I hope I'm not disturbing ~ you two in anything private.''

in short               = короче говоря, словом
''Bad for the health; ~ useless for the soul; ~ opposed, '''in short''', ~ to the obvious laws ~ of Hygiene and ~ common sense.'' = %% Herman Melville, ''Moby Dick'' ~ NAXOS HOOTKINS
in the mass            = в целом
upon the whole         = в целом


meanwhile              = тем временем
at this time           = на этот раз
and sometimes          = а иногда
and now                = и вот
one day {parenthesis}  = в один прекрасный день
''One day when you get older, ~ you'll understand.''
''One day when you get older, ~ you'll thank me for this.''
and behold             = смотри! вот! %% old-fashioned, literary

fortunately//luckily   = к счастью
unfortunately          = к несчастью
paradoxically enough   = странным образом

so that                = так что
as mentioned above     = как отмечалось выше
as has been said       = как уже было сказано

believe me             = поверьте
honestly speaking      = честно говоря
frankly speaking       = откровенно говоря
speaking roughly       = грубо говоря
in my opinion          = по моему мнению
in my humble opinion   = по моему скромному мнению %% IMHO
as far as I know       = насколько я знаю %% AFAIK

I should say           = должен сказать, что
I dare say             = смею сказать
I tell you this:       = скажу так:
I must confess         = должен признаться
I'm afraid             = боюсь, что/но
I'm sorry but          = простите, но

it is becoming evident = становится очевидно
it is difficult to say = трудно сказать
comparatively speaking = для сравнения

