bon appétit!               = приятного аппетита! %% (фр.)     #  6+ # us-
appetite                   = аппетит, охота ~ (до чего-либо)
apéritif|aperitif          = аперитив                         # 18+

soup                       = суп
cream soup                 = суп-пюре
bouillon                   = бульон %% или суп на бульоне
consommé|consomme          = консоме %% осветлённый бульон    # 18+ # RARE+
escalope {Br.}             = эскалоп                          # 10+
fillet\\filet              = филе                             # 10+
fricassee                  = фрикасе                          # 18+ # RARE+

baguette                   = багет
croissant                  = круассан
galette                    = галета                           # 10+

mayonnaise                 = майонез
margarine                  = маргарин                         # 10+
marinade                   = маринад                          # 10+
omelette\\omelet           = омлет
sauce                      = соус, изюминка %% Предок французского sauce («соус») – ~ латинское слово sal («соль»). /// ; то, что придаёт пикантность
lemonade                   = лимонад
champignon                 = шампиньон                        # 10+
flambé                     = фламбирование/фламбе             # 18+ # RARE-
fondue                     = фондю                            # 16+ # RARE- # MILK

dessert                    = десерт
caramel                    = карамель
crème brûlée               = крем-брюле                       # 10+
blancmange                 = бланманже                        # 18+ # RARE-
éclair|eclair              = эклер
mousse                     = мусс                             # 10+
profiteroles {Br.}         = профитроли                       # 16+ # RARE-
souffle|soufflé            = суфле                            # 10+

cafe|café                  = кафе
restaurant                 = ресторан
menu                       = меню
maître d'hôtel\\maître d'  = метрдотель                       # 18+
chef                       = шеф-повар
gourmand                   = гурман, также: обжора
banquet                    = банкет                           # 16+ /// , давать банкет
picnic                     = пикник                           /// , устраивать пикник
champagne                  = шампанское                       # 18+
cognac                     = коньяк                           # 18+
