à la guerre ~ comme à la guerre = на войне как на войне %% (фр.)             # 14+ # RANDOM- # us-

army                     = армия                                      /// , вооружённые силы, ~~масса, множество
artillery                = артиллерия
calibre\\caliber         = калибр                                     #     # WAR- /// , диаметр ~~ масштаб, уровень (достижений и т.п.)
camouflage               = камуфляж, маскировка, ~ камуфлировать, камуфляжный # 10+
campaign                 = кампания                                   # 16+ /// , ~~участвовать в кампании, проводить кампанию
front                    = фронт                                      # 10+ # polysemic /// , ~ передний, перед /// очень много знач.
flank                    = фланг                                      # 10+ # polysemic /// защищать с фланга, атаковать с фланга, ~~ бок, склон (холма), располагаться сбоку
patrol                   = патруль, патрулировать                     # 10+ /// , патрулирование
picket                   = пикет, дозор                               # 18+ # WAR- /// пикет, пикетчик, дозор, ~~пикетировать, расставлять заставы
ricochet                 = рикошет                                    # 10+ /// , отскочить рикошетом
palisade                 = палисад, частокол                          # 18+ /// , обносить частоколом, ~~ряд базальтовых столбов
embrasure                = амбразура, бойница                         # 18+ # WAR-
trench                   = окоп, траншея                              # 10+ /// # polysemic /// , ~~рыть окопы, траншеи /// океанская впадина /// , канава и др.
garrison                 = гарнизон                                   # 16+ # WAR-

cadet                    = кадет                                      #     # WAR-
sergeant                 = сержант                                    #     # WAR-
officer                  = офицер, ~ также: должностное лицо, ~ чиновник, служащий # 14+ # RANDOM-
lieutenant               = лейтенант, ~ заместитель, помощник         #     # WAR-
captain                  = капитан, командир экипажа, ~ лидер, вожак  #     # WAR-
general                  = генерал, командующий                       #     # WAR- # polysemic
marshal                  = маршал                                     # 10+ # WAR- # polysemic /// выстраивать в правильном порядке и др.

escort {noun}            = эскорт, сопровождение                      # 14+ /// `escort
escort {verb} %% <verb>  = эскортировать, сопровождать                # 14+ /// es`cort
parade                   = парад
chevron                  = шеврон                                     # 18+ # WAR-
epaulettes {esp.} {Br.}\\{Am.} {usually} epaulets = эполеты                                    # 10+ # WAR-
kepi                     = кепи                                       # 18+ # WAR-

musketeer                = мушкетёр                                   # 12+ # HISTORY- # WAR-
cavalry                  = кавалерия, конница                         # 14+ # HISTORY- # WAR-
cavalcade                = кавалькада, процессия                      # 18+ # HISTORY- # WAR-
gallop                   = галоп, нестись                             # 10+ # HISTORY- # WAR- /// галоп, большая скорость, ~~скакать галопом, нестись
cuirass                  = кираса, ~ в зоологии: панцирь              # 12+ # HISTORY- # WAR-

revanchism               = реваншизм                                  # 14+ # WAR-
