à la guerre ~ comme à la guerre = на войне как на войне %% (фр.)                   # 14+

army @ military       = армия                                            /// , вооружённые силы, ~~масса, множество
artillery             = артиллерия
calibre\\caliber      = калибр                                           # WAR- /// , диаметр ~~ масштаб, уровень (достижений и т.п.)
camouflage            = камуфляж, маскировка, ~ камуфлировать, камуфляжный # 10+
campaign              = кампания                                         # 16+ /// , ~~участвовать в кампании, проводить кампанию
front @ military      = фронт                                            # 10+ /// , ~ передний, перед /// очень много знач.
flank @ military      = фланг                                            # 10+ /// защищать с фланга, атаковать с фланга, ~~ бок, склон (холма), располагаться сбоку
patrol                = патруль, патрулировать                           # 10+ /// , патрулирование
picket                = пикет, дозор                                     # WAR- # 18+ /// пикет, пикетчик, дозор, ~~пикетировать, расставлять заставы
ricochet              = рикошет                                          # 10+ /// , отскочить рикошетом
palisade              = палисад, частокол                                # 18+ /// , обносить частоколом, ~~ряд базальтовых столбов
embrasure             = амбразура, бойница                               # WAR- # 18+
trench                = окоп, траншея                                    # 10+ /// # polysemic /// , ~~рыть окопы, траншеи /// океанская впадина /// , канава и др.
garrison              = гарнизон                                         # WAR- # 16+

cadet                 = кадет                                            # WAR-
sergeant              = сержант                                          # WAR-
officer @ rank        = офицер, ~ также: должностное лицо, ~ чиновник, служащий # 14+
lieutenant            = лейтенант, ~ заместитель, помощник               # WAR-
captain @ rank        = капитан, командир экипажа, ~ лидер, вожак        # WAR-
general @ rank        = генерал, командующий                             # WAR-
marshal @ rank        = маршал                                           # WAR- # 10+ /// выстраивать в правильном порядке и др.

escort @ noun %% noun = эскорт, сопровождение                            # 14+ /// `escort
escort @ verb %% verb = эскортировать, сопровождать                      # 14+ /// es`cort
parade @ military     = парад
chevron               = шеврон                                           # WAR- # 18+
epaulettes {esp.} {Br.}\\{Am.} {usually} epaulets = эполеты                                          # WAR- # 10+
kepi                  = кепи                                             # WAR- # 18+

musketeer             = мушкетёр                                         # HISTORY- # WAR- # 12+
cavalry               = кавалерия, конница                               # HISTORY- # WAR- # 14+
cavalcade             = кавалькада, процессия                            # HISTORY- # WAR- # 18+
gallop                = галоп, нестись                                   # HISTORY- # WAR- # 10+ /// галоп, большая скорость, ~~скакать галопом, нестись
cuirass               = кираса, ~ в зоологии: панцирь                    # HISTORY- # WAR- # 12+

revanchism            = реваншизм                                        # WAR- # 14+








