aeroplane/plane\\airplane/plane = самолёт, аэроплан

airport                     = аэропорт
aerodrome\\airdrome %% old-fashioned = аэродром

air                         = воздух
airliner                    = авиалайнер
airline                     = авиакомпания
air lane~airway             = авиалиния, воздушная трасса
air corridor                = воздушный корридор               # TECH- # TERM- # 10+

terminal                    = терминал                         # 10+
hangar                      = ангар                            # 10+

helicopter                  = вертолёт                         # 10+
rotor                       = ротор ~ (несущий винт)           # TECH+ # 10+
quadcopter                  = квадрокоптер                     # TECH+ # 10+
biplane                     = биплан                           # TECH- # 10+
propeller                   = пропеллер, воздушный винт        /// винт (корабля)

pilot                       = пилот, лётчик
navigator                   = штурман                          # 10+
navigation                  = навигация                        # 10+
orientation,~disorientation = ориентация, ~ дезориентация      # 10+

radar                       = радар                            # 10+
autopilot                   = автопилот
avionics                    = авионика ~ (бортовая электроника) # TECH+ # 18+

vertical stabilizer         = вертикальный стабилизатор        # TECH- # 10+
turbulence                  = турбулентность, ~ беспокойство, волнение

aerostat                    = аэростат                         # TECH- # 10+
aerobatics                  = высший пилотаж ~ (аэробатика)    # 12+
aerodynamics                = аэродинамика, ~ аэродинамические характеристики # MATH- # TECH- # 10+
air traffic controller      = авиадиспетчер                    # TERM- # 10+

= Ещё «воздушные» слова, не относящиеся к авиации: # 10+

air conditioner             = кондиционер                      # 10+ /// False friends
air mattress                = надувной матрас                  # 10+

aerobics                    = аэробика                         # 10+
aerosol                     = аэрозоль                         # 10+
aerogel                     = аэрогель                         # TECH+ # 16+
aerography                  = аэрография                       # 10+

on air                      = в эфире ~ (радио или телевидения) # 10+ /// 8


