Middle Ages           = Средние века

celts                 = кельты
Anglo-Saxons          = англосаксы
Vikings               = викинги                                       /// VIII—XI век
Normans               = норма́нны

===

Joan of Arc           = Жанна Д'Арк                                   /// Hundred Years' War, 1337 to 1453
The Wars of the Roses = войны Роз %% война Алой и Белой розы          /// 1455—1485

tournament @ knight   = соревнование, турнир ~ рыцарский турнир

doge                  = дож                                           # 14+
vendetta              = вендетта                                      # 14+

grandee               = гранд %% высший дворянский титул ~ в средневековой Испании # HISTORY+ # 16+
hidalgo               = идальго                                       # HISTORY- # 16+
caballero             = кабальеро                                     # HISTORY- # 16+

===

peer @ noble          = пэр                                           # 14+
lord                  = лорд                                          # 14+
: But this is not all, my Lord.

baronet               = баронет %% промежуточный титул ~ между рыцарем и бароном # HISTORY+ # 16+
baronetess            = баронетесса                                   # HISTORY+ # RARE+ # 16+
---
genealogy             = генеалогия, родословная                       # 14+
family tree           = генеалогическое древо                         # 14+
heraldry              = геральдика                                    # 16+
herald                = герольд, глашатай, ~ вестник (короля)         # HISTORY- # 16+
fleur-de-lis          = флёр-де-лис %% геральдическая лилия           # 16+

manor                 = манор %% феодальное поместье ~ в средневековой Англии /// French

===
duel                  = дуэль
dueler//duelist       = дуэлянт
duelling pistols      = дуэльные пистолеты                            # HISTORY+ # WAR+ # 14+
second @ duel         = секундант                                     # HISTORY- # WAR-
===
Moors                 = мавры                                         # 16+ /// ам. обычно: \ˈmu̇r\
Reconquista           = Реконкиста %% отвоевание Пиренеев у мавров, VIII-XV вв. # 16+
===

Fernand Magellan      = Фернан Магеллан
Vasco da Gama         = Васко да Гама
Marco Polo            = Марко Поло




