Germanic ~ mythology   = германская мифология
Celtic ~ mythology     = кельтская мифология                                  # 10+

Odin %% (Wōden/Wōtan)  = Один/Вотан                                           # 14+
Loki                   = Локи                                                 # 14+
Thor                   = Тор                                                  # 14+
Fenrir %% (Fenrisúlfr) = Фе́нрир %% Фенрир – могучий волк, посаженный богами на цепь. Согласно пророчеству, перед концом света он освободится от своих оков и убьет Одина. # 16+
Asgard                 = А́сгард %% место обитания богов                       # 16+
Valhalla               = Вальгалла/Вальхалла                                  # 16+
Yggdrasil              = Иггдрасиль %% Иггдрасиль – это исполинский ясень. Корнями он уходит в мир мертвых и растет сквозь все миры, достигая края богов. # 16+
Ragnarök||Ragnarok     = Рагнарёк/Рагнарок %% гибель мира и богов             # 16+
Niblungs               = Нибелунги                                            # 16+
Siegfried              = Зигфрид                                              # 16+
Valkyrie               = валькирия                                            # 10+

===

troll                  = тролль
ogre                   = огр %% великан-людоед
goblin                 = гоблин
elf                    = эльф

pixie                  = пикси %% Озорное существо родом из английского фольклора. Писки напоминают фей или эльфов и часто изображаются с заостренными ушами. # RARE- # 10+
selkies                = шелки/селки %% люди-тюлени                           # 16+ /// /selchies
banshee                = банши %% Фея, призрак, покровительница рода. Облик банши может быть различным, но одно остается неизменным: ее зловещие завывания, предвещающие близкую смерть человека. # 16+
leprechaun             = лепрекон                                             # 10+

druid                  = друид                                                # 10+
runes                  = руны                                                 # 10+

===
King Arthur            = король Артур
===

Excalibur//Caliburn    = Экскалибур/Ка́либурн %% меч короля Артура             # 10+
Lancelot               = Ланселот                                             # 16+
Guinevere              = Гвиневра/Гвиневера/Гиневра                           # 16+
damsel in distress     = дева в беде %% преследуемая дева                     # RARE- # 14+
Percival||Perceval     = Парцифаль/Персиваль                                  # 16+
accolade               = акколада %% посвящение в рыцари                      # RARE- # 16+
Holy Grail             = Святой/Священный Грааль                              # 10+
Tristan and Isolde %% (Tristan and Iseult) = Тристан и Изольда                                    # 16+

===
---
Merlin                 = Мерлин                                               # 10+
Morgan le Fay          = фея Моргана                                          # 16+
Fata Morgana           = фата-моргана %% вид миража ~~ итал. fata Morgana — фея Моргана # 16+

Beowulf                = Беовульф %% герой англосаксонского эпоса             # 16+

Robin Hood             = Робин Гуд



