Greek                    = греческий     # 8+

---
athlete                  = атлет, спортсмен /// легкоатлет, спортсмен
acrobat                  = акробат
: An acrobat, eh?  ~ Good, good, good!

pirate                   = пират, пиратский /// , заниматься пиратством
panorama                 = вид, панорама # 12+ /// , ~~обзор, панорама событий
hippodrome               = ипподром      # 14+ /// , в Древней Греции и Риме: ристалище

cataclysm                = катаклизм     # 10+
catastrophe              = катастрофа
chaos                    = хаос          # 10+
basis                    = основа, базис # 16+
zodiac                   = зодиак        # 10+
comet                    = комета

atmosphere @ planet      = атмосфера ~ (планеты)
atmosphere @ mood        = атмосфера, обстановка, ~ создавать атмосферу

euphoria                 = эйфория       # 16+
irony                    = ирония        # 10+
sarcasm                  = сарказм       # 10+
anecdote                 = анекдот ~ (в знач. «случай из жизни») %% анекдот в знач. «шутка» -- joke # 16+

antipode                 = антипод       # 14+
barbarian                = варвар, варварский
archaic                  = архаичный, устаревший
amorphous                = аморфный, бесформенный # 14+ /// , в минералогии: некристаллический, бесструктурный
asymmetric//asymmetrical = асимметричный # 10+
elastic                  = эластичный, ~ гибкий, упругий # 10+ /// #polysemic /// подвязка для чулок, резинка и др.

cosmetics                = косметика     /// , косметический ???
aroma                    = аромат        # 10+
diadem                   = диадема, корона # 16+ /// , ~~слава, величие
sandal @ shoe            = сандалия      # 10+ /// #homonyms /// , ремешок (сандалии)
talisman                 = талисман
amphora                  = амфора        # 16+


