basic ~ vocabulary

rain                  = дождь, ~ идти (о дожде)
wind  @ air {n}       = ветер
sky                   = небо
cloud {n}             = облако
rainbow               = радуга
---
sunrise               = восход
sunset                = закат
morning               = утро
day                   = день
evening               = вечер
night                 = вечер, ночь # duple

ice                   = лед
drop @ water          = капля, капать, ~ падать, уронить
river                 = река
lake                  = озеро

---
stone @ rock          = камень
rock @ moutain        = скала, утёс
rock @ stone          = камень, булыжник
mountains             = горы
hill                  = холм

---
sea                   = море
surf @ waves          = прибой
shell/seashell        = раковина
sand                  = песок

---
forest                = лес
oak                   = дуб
maple                 = клен
pine                  = сосна
spruce                = хвойное дерево, ~ ель
grass                 = трава

berries               = ягоды
mushrooms             = грибы
nuts @ fruits         = орехи

---
winter                = зима
spring @ season       = весна
summer                = лето
autumn\\fall @ season = осень






