strategic                  = стратегический
strategist                 = стратег

morale                     = моральное состояние, боевой дух
demoralisation\\demoralization = деморализация                     /// нечеткое разделение на бр. ам.
disorganisation\\disorganization = дезорганизация                    /// нечеткое разделение на бр. ам.

march                      = марш, маршировать %% также: организованное перемещение войск (в пешем порядке, на животных или на машинах)
march                      = марш, демонстрация %% политическая # 14+
March                      = март

mobility                   = мобильность, подвижность
motorized                  = моторизованный

concentrate                = сосредотачивать, концентрировать, концентрироваться
equip                      = оборудовать, снаряжать, вооружать, экипировать
evacuation                 = эвакуация
materiel                   = материальная часть, ~ боевая техника # 16+
strategic materials        = стратегические материалы          # WAR+ # 16+ /// стратегическое сырье

mobilisation\\mobilization = мобилизация                       /// нечеткое разделение
demobilisation\\demobilization = демобилизация                     /// нечеткое разделение


tactical                   = тактический
tactician                  = тактик

frontal attack             = фронтальная атака                 # WAR-
flanking manoeuvre\\flanking maneuver = фланговый манёвр                  # WAR-
preventive attack          = превентивный удар %% упреждающий  # WAR- # 16+

front line                 = линия фронта
blockade                   = блокада, блокировать
storming                   = штурм
raid                       = рейд, облава, ~ устраивать облаву, ~ налёт, набег # 10+

echelon                    = эшелон                            # WAR- # 16+
forage                     = корм, фураж, ~ добывать продовольствие, ~ разыскивать # WAR-

vanguard                   = в военном деле: авангард          # WAR- # RANDOM- # 16+
rearguard                  = арьергард                         # WAR- # 16+

