Bible              = Библия
===
Eden               = Эдем            # TERM-
Adam and Eve       = Адам и Ева
Abel and Cain      = Авель и Каин    # TERM-
===
Noah's ark         = Ноев ковчег
Mount Ararat       = гора Арарат
Tower of Babel     = Вавилонская башня
Sodom and Gomorrah = Содом и Гоморра

Exodus             = Исход
Moses              = Моисей
manna              = манна

David @ biblical   = Давид
Goliath            = Голиаф

Solomon            = Соломон         # TERM-
Ecclesiastes       = Экклезиаст      # TERM+
---
Satan              = Сатана
Lucifer            = Люцифер
= %% в римском переводе Библии -- ~ образ «утренней звезды» (Венеры)
= %% в христианстве с XVII века — ~ синоним падшего ангела, ~ отождествляемого ~ с Сатаной и дьяволом

seraph %% plural: seraphs/seraphim = серафим
archangel Michael  = архангел Михаил # TERM-
archangel Gabriel  = архангел Гавриил # TERM-

Behemoth           = Бегемот
Leviathan          = Левиафан

===
Evangelist         = евангелист %% один из четырёх авторов Евангелий
evangelist         = проповедник Евангелия, ~ протестантсткий миссионер
===

apostle %% formal  = приверженец, поборник, ~ апостол
Judas Iscariot     = Иуда Искариот
Pontius Pilate     = Понтий Пилат    # TERM+

===
Book of Revelation//Apocalypse = Откровение Иоанна Богослова, ~ Апокалипсис %% последняя книга ~ Нового Завета
Armageddon         = Армагеддон %% место последней битвы добра со злом; ~ сама битва



