psychology                   = психология                            # pix-
---
psychoanalysis               = психоанализ
psychoanalyst                = психоаналитик
psychologist                 = психолог

mental block                 = ментальный блок
psychological barrier        = психологический барьер
personality disorder         = расстройство личности
mass hysteria                = массовая истерия

psychosis                    = психоз
paranoia                     = паранойя
phobia                       = фобия
mania                        = мания                                 # duple

latent                       = латентный, скрытый
fetish                       = фети́ш                                 /// фе́тиш
---
sadism                       = садизм
masochism                    = мазохизм

===

claustrophobia               = клаустрофобия
kleptomania                  = клептомания
Oedipus complex              = эдипов комплекс

===

introspection                = интроспекция, самоанализ              # RARE+ # TERM+
projection @ psycho          = в психологии: проекция                # RARE+ # TERM+
cognitive dissonance         = когнитивный диссонанс                 # TERM+

gestalt                      = гештальт %% целостный образ           # RARE+ # TERM+

egotism                      = эготизм %% преувеличенное мнение о себе # RARE+ # TERM+
egocentrism                  = эгоцентризм                           # RARE+ # TERM+

neuro-linguistic programming = нейролингвистическое программирование # TERM-

hypnosis                     = гипноз
hallucination                = галлюцинация






