business                   = бизнес, фирма, ~ деловая активность, работа, ~ дело, занятие # 10+
businessman,~businesswoman = бизнесмен, бизнесвумен
business plan              = бизнес-план                                # POLIT- # 18+
business card              = визитная карточка, визитка                 # 10+
startup [company]          = стартап                                    # POLIT- # 10+

client                     = клиент
service                    = служба, услуга, сервис

contract                   = контракт, договор, ~ заключать договор
deal                       = сделка, ~ распределять, ~ иметь дело (с чем-либо)
confidentiality            = конфиденциальность                         # 10+

exploitation               = эксплуатация %% людей и природных ресурсов # 14+
interest                   = интерес, выгода, проценты                  # 14+
crash                      = крах, крушение, рушиться


commerce                   = торговля, коммерция

supermarket,~hypermarket   = супермаркет, гипермаркет

shopping centre\\shopping center = торговый центр
[shopping] mall (Am.)      = торговый центр, молл
shopping                   = шоппинг, поход по магазинам

cashier                    = кассир                                     /// увольнять
cash                       = деньги, наличные деньги
<small>''Will that be cash?''</small>
safe                       = сейф, ~ безопасный, надежный               /// также: защищенный от опасности

dealer                     = дилер, торговец                            # POLIT- # 18+
distributor                = дистрибьютор, ~ агент по продаже, ~ распространитель # POLIT- # TERM- # 18+
pricelist/~price list      = прейскурант, прайс-лист                    # 18+ /// (список цен)
coupon                     = купон, талон                               # 18+

millionaire                = миллионер
billionaire                = миллиардер
pyramid scheme             = финансовая/инвестиционная пирамида         # 18+

certificate                = сертификат                                 # 14+
licence\\license           = лицензия, разрешение, свидетельство        # 14+
license                    = давать право/разрешение                    # 14+

rent                       = рента, арендная плата, ~ арендовать жилье, ~ брать напрокат # 18+

inventory                  = инвентаризационная опись                   # POLIT+ # TERM+ # 18+
inventory (Am.)            = инвентаризация, ~ инвентарь                # POLIT+ # TERM+ # 18+

